1, 1, 1, 1, 1, 1, 8, 1, 1, 1, 1, 1, 1
1, 1, 1, 1, 1, 1, 8, 1, 1, 1, 1, 1, 1
1, 1, 1, 1, 1, 1, 8, 1, 1, 1, 1, 1, 1
1, 1, 1, 1, 1, 1, 8, 1, 1, 1, 1, 1, 1
0, 0, 0, 0, 0, 0, 8, 0, 0, 0, 0, 0, 0
0, 8, 0, 8, 0, 8, 8, 8, 0, 8, 0, 8, 0
0, 0, 0, 0, 0, 0, 8, 0, 0, 0, 0, 0, 0
0, 0, 0, 0, 9, 0, 8, 0, 9, 0, 0, 0, 0
0, 0, 7, 0, 0, 0, 8, 0, 0, 0, 7, 0, 0
0, 0, 0, 0, 0, 0, 0, 0, 0, 0, 0, 0, 0
0, 0, 0, 0, 7, 0, 0, 0, 0, 0, 0, 0, 0
0, 0, 0, 0, 0, 0, 0, 0, 7, 0, 0, 0, 0
0, 0, 0, 0, 0, 0, 0, 0, 0, 0, 0, 0, 0
0, 9, 0, 0, 0, 0, 0, 0, 0, 0, 0, 0, 0
0, 0, 0, 0, 0, 0, 0, 0, 0, 0, 0, 9, 0
0, 0, 0, 0, 0, 0, 9, 0, 0, 0, 0, 0, 0
0, 0, 0, 0, 0, 0, 0, 0, 0, 0, 0, 0, 0