0, 0, 0, 6, 6, 6, 6, 6, 6, 6, 0, 0, 0
0, 0, 0, 6, 6, 6, 6, 6, 6, 6, 0, 0, 0
0, 6, 0, 6, 6, 6, 6, 6, 6, 6, 0, 6, 0
0, 6, 0, 1, 1, 1, 1, 1, 1, 1, 0, 6, 0
0, 6, 0, 1, 1, 1, 1, 1, 1, 1, 0, 6, 0
0, 6, 0, 3, 3, 3, 3, 3, 3, 3, 0, 6, 0
0, 6, 0, 0, 0, 0, 0, 0, 0, 0, 0, 6, 0
0, 6, 0, 0, 0, 0, 0, 0, 0, 0, 0, 6, 0
0, 6, 0, 3, 3, 3, 3, 3, 3, 3, 0, 6, 0
0, 6, 0, 1, 1, 1, 1, 1, 1, 1, 0, 6, 0
0, 6, 6, 6, 6, 6, 6, 6, 6, 6, 6, 6, 0
0, 6, 6, 6, 6, 6, 6, 6, 6, 6, 6, 6, 0
0, 0, 0, 0, 0, 0, 0, 0, 0, 0, 0, 0, 0
0, 0, 0, 0, 0, 0, 0, 0, 0, 0, 0, 0, 0
0, 0, 0, 0, 0, 0, 0, 0, 0, 0, 0, 0, 0
0, 0, 0, 0, 0, 0, 0, 0, 0, 0, 0, 0, 0
0, 0, 0, 0, 0, 0, 0, 0, 0, 0, 0, 0, 0