0, 0, 0, 0, 1, 1, 1, 1, 1, 0, 0, 0, 0
0, 0, 0, 0, 3, 3, 3, 3, 3, 0, 0, 0, 0
3, 3, 3, 0, 7, 0, 0, 0, 0, 0, 3, 3, 3
5, 5, 5, 0, 0, 0, 7, 0, 0, 0, 5, 5, 5
5, 5, 5, 0, 0, 0, 0, 0, 7, 0, 5, 5, 5
4, 4, 4, 0, 0, 7, 0, 0, 0, 0, 4, 4, 4
4, 4, 4, 0, 0, 0, 0, 7, 0, 0, 4, 4, 4
0, 0, 0, 0, 0, 0, 7, 0, 0, 0, 0, 0, 0
0, 0, 0, 0, 1, 1, 1, 1, 1, 0, 0, 0, 0
0, 6, 6, 6, 6, 6, 6, 6, 6, 6, 6, 6, 0
0, 6, 2, 2, 2, 2, 2, 2, 2, 2, 2, 6, 0
0, 6, 0, 0, 0, 0, 0, 0, 0, 0, 0, 6, 0
0, 0, 0, 0, 0, 0, 0, 0, 0, 0, 0, 0, 0
0, 0, 0, 0, 0, 0, 0, 0, 0, 0, 0, 0, 0
0, 0, 0, 0, 0, 0, 0, 0, 0, 0, 0, 0, 0
0, 0, 0, 0, 0, 0, 0, 0, 0, 0, 0, 0, 0
0, 0, 0, 0, 0, 0, 0, 0, 0, 0, 0, 0, 0